####################
#f...#........#....#
#.#..............#.#
#.#.##.##g.##.##.#.#
#o.....#bpic#......#
#.#.##.######.##.#.#
#.#..............#.#
#.##.#.######.#.##.#
#....#........#...f#
####################