####################
#.................f#
#.#..#.#....#.#..#.#
#.#..#.#....#.#..#.#
#.#..#.#....#.#..#.#
#o#..#.#bpic#.#..#.#
#.#..#.#.##.#.#..#.#
#.#..#.######.#..#.#
#.####.##..##.####.#
#f.................#
####################