####################
#.................f#
#.#.#.########.#.#.#
#.#.#............#.#
#.####.##g.##.##.#.#
#......#bpic#......#
#.#..#.######.#..#.#
#.##.#.######.#.##.#
#f.................#
####################