####################
#.................f#
#.#.#..######.#..#.#
#.#.#.########.#.#.#
#.#.#............#.#
#.####.##..##.##.#.#
#......#bpic#......#
#.#..#.######.#..#.#
#.##.#.######.#.##.#
#f.................#
####################