####################
#f...#........#....#
#.##.#.######.#.##.#
#.#..............#.#
#.#.##.##  ##.##.#.#
#o.....#bpic#......#
#.#.##.######.##.#.#
#.#..............#.#
#.##.#.######.#.##.#
#....#........#...f#
####################